F 103,93,80
NO ./imgs/N.xpm
SO ./imgs/S.xpm

C 184,231,225
WE ./imgs/w.xpm
EA ./imgs/E.xpm


 1111111111
 1M0000MN01
 11M1001001
 1000000001
 1111111111