F 220,100,0
NO ./IMGS/N_wall.xpm
SO ./IMGS/S_wall.xpm
C 225,30,0

EA ./IMGS/E_wall.xpm
WE ./IMGS/W_wall.xpm

 1111111111
 1M00000N01
 1000000001
 1111111111