F 220,100,0
NO ./path_to_the_north_texture
SO ./path_to_the_south_texture
C 225,30,0

EA ./path_to_the_east_texture
WE ./path_to_the_west_texture

 1111111111
 1111111111
 1111N11111
 1111111111