F 103,93,,,,,,,,,,,,,,,,,,,,,,,,,,,,,,,,,,,,,,,,,,,,,,,,,,,,,,,,,,,,,,,,,,,,,,,,,,,,,,,,,,,,,,,,,,,,,,,80
C 103,93,80

NO ./imgs/N.xpm
SO ./imgs/S.xpm
WE ./imgs/W.xpm
EA ./imgs/E.xpm

11111
10001
10001   11111
100N1   10001
11111   11111
