F 103,93,80
C 184,231,225

NO ./imgs/N.xpm
SO ./imgs/S.xpm
WE ./imgs/W.xpm
EA ./imgs/E.xpm


11111
1   1
10001
100N1
11111