F 220,100,0
NO ./imgs/N_wall.xpm
SO ./imgs/S_wall.xpm
C 225,30,0

EA ./imgs/E_wall.xpm
WE ./imgs/W_wall.xpm

 1111111111
 1M000  MN01
 1100000001
 1111111111