F 103,93,80
NO ./imgs/N.xpm
SO ./imgs/S.xpm

C 184,231,225
WE ./imgs/W.xpm
EA ./imgs/E.xpm


 1111111111111111111111111111
 1010100010001000100000100011
 1010101000100010001010001001
 1010111111111110111111111111
 1010000000000000000000000001
 1010111111111010000000000001
 1010100000000010000000000001
 1010101111111010000N00000001
 1010100000000010000000000001
 1010111110111110000000000001
 1010100000100010000000000001
 1010100000100010000000000001
 1010100000100010000000000001
 1010100000100010000000000001
 10M0M00000M000M0000000000001
 1111111111111111111111111111