F 2,82,82
NO ./imgs/N_wall.xpm
SO ./imgs/S_wall.xpm

C 100,149,237
WE ./imgs/W_wall.xpm
EA ./imgs/E_wall.xpm



        1111111111111111111111111
        1000000000110000000000001
        1011000001110000000000001
        1001000000000000000000001
111111111011000001110000000000001
100000000011000001110111111111111
111101111111110000000000M0001
11110111111111111101010010001
1100000011011  11100000010001
10000000000011111100000011M11
10000000000000000M00000000001
11000001110101011111M11110N0111
11110111 1110101 100001000001
11111111 1111111 111111111111